#domain
hospital
#levelname
magnus_test
#colors
blue: 0, A
#initial
+++++++++++++++++++
+0               A+
+                 +
+++++++++++++++++++
#goal
+++++++++++++++++++
+                 +
+A                +
+++++++++++++++++++
#end